32 32 32 32 32 32 32 32 32 32 32 32 32 32 32 32
32 2 2 2 2 2 2 2 2 2 2 2 2 2 2 32
32 2 32 32 2 19 19 19 19 19 2 32 32 2 2 32
32 2 32 2 2 19 2 2 2 19 2 2 32 2 2 32
32 2 32 2 2 19 2 2 2 19 2 2 32 2 2 32
32 2 2 2 2 19 19 19 19 19 2 2 2 2 2 32
32 2 32 32 2 2 2 2 2 2 2 32 32 2 2 32
32 2 2 32 2 32 32 32 32 32 2 2 32 2 2 32
32 2 2 32 2 32 2 2 2 32 2 2 32 2 2 32
32 2 2 2 2 32 2 2 2 32 2 2 2 2 2 32
32 2 2 2 2 2 2 2 2 2 2 2 2 2 2 32
32 32 32 32 32 32 32 32 32 32 32 32 32 32 32 32
